NO ./assets/MultibrickL.xpm
SO ./assets/MultibrickL.xpm
WE ./assets/neon_brick_wall_64.xpm
EA ./assets/neon_brick_wall_64.xpm

F 220,100,0
C 225,30,0

11111111111111111111111111111111111111111111
10000000000000000000000000000000000000000001
10000000000000000000000000000000000000000001
10000000000000000100000000000000000000000001
10000000000000000010000000000000000000000001
10000000000000000001000000000000000000000001
10000000000000000000100000000000000000000001
1000000000000000000000S000000000000000000001
10000000001111111111110111111111000000000001
10000000000000000000000000000000000000000001
10000000000000011111111100000000000000000001
10000000000000000000000000000000000000000001
10000000000000000000000000000000000000000001
10000000000000000000000000000000000000000001
10000000000000000000000000000000000000000001
10000000000000000000000000000000000000000001
10000000000000000000000000000000000000000001
10000000000000000000000000000000000000000001
11111111111111111111111111111111111111111111