NO ./assets/neovim.xpm
SO ./assets/neovim.xpm
WE ./assets/neovim.xpm
EA ./assets/neovim.xpm

F 100,100,100
C 50,50,220

11111111111111111111111111111111111111111111
10000000001100000000001100000000001100000001
10111111001011101111100101111111001011111101
10000001000010001000100010000001000010000001
11101101111010111010111010111011111010111011
10001000001000100010001000100000001000100001
10111011101111101111101111101111101111101101
10000010001000001000001000001000001000001001
11111010111011111011111011111011111011101001
10001000100010000010000010000010000010001001
10101111101110111110111110111110111110111001
10001000001000100000100000100000100000100001
10111011111011101111101111101111101111101101
10000000000010001000001000001000001000000001
10111111111010111011111011111011111011111101
1000000000100010000000000000000010000000S001
11111111111111111111111111111111111111111111
